11111111111
10000000001
10111011101
10001010001
10111111101
10000000001
10111111101
10000000001
10101111101
10000000001
11111111111
