1111111111111
1000000000001
1011111111101
1010000000001
1010111111101
1010000010001
1110111010101
1000100000101
1010111011101
1000000000001
1000000011101
1000000000001
1111111111111
