1111111111111
1000000000001
1011111111101
1000000000001
1011111111101
1000000000101
1011111011101
1000000000001
1011111111101
1000000000001
1011111111101
1000000000001
1111111111111
