1111111111111
1000000000001
1011111111101
1010000000001
1010111111101
1010000000101
1011111110101
1000000000001
1011111111101
1000000000001
1011101111101
1000000000001
1111111111111
