11111111111
10000000001
10111111101
10000000101
10111111101
10000000101
10111110101
10000010001
11111110101
10000000001
11111111111
