1111111111111
1000000000001
1011111011101
1000001010001
1011111110101
1010000000101
1010111111101
1010000000101
1011111110101
1000000010101
1011111011101
1000000000001
1111111111111
