1111111111111
1000000000001
1111111111101
1000000000001
1011111111101
1000100000001
1010101111101
1010000000101
1010111110101
1010100000101
1110111011101
1000000000001
1111111111111
