1111111111111
1000000000001
1011111111101
1000000000101
1011101110101
1000100010101
1010101110101
1010100000001
1111101111101
1000001000001
1111111011101
1000000000001
1111111111111
