1111111111111
1000000000001
1011111111101
1010000000001
1010101111101
1010001000001
1011111011101
1000000000001
1011111110101
1000000010101
1111111111101
1000000000001
1111111111111
