11111111111
10000000001
10111111101
10100000001
10111110101
10000000101
10111110101
10000010101
10000011101
10000000001
11111111111
