11111111111
10000000001
10111111101
10000000001
10111110101
10000010001
10111011101
10100000101
11101110101
10000000001
11111111111
