11111111111
10000000001
10101111101
10101000001
10111110101
10000010101
10111010101
10000000101
10111111101
10000000001
11111111111
