11111111111
10000000001
10111011101
10001000101
10111011101
10100000101
10111110101
10000000101
11111111101
10000000001
11111111111
