11111111111
10000000001
10111110101
10000010101
10101110101
10001000001
11111011101
10000000101
10101111101
10000000001
11111111111
